1900002389104
1900002395104
1900002399104
1900002425104
1900002428104
1900002430104
1900002789104
1900002795104
1900002799104
1900002877104
1900003638104
1900003710104
1900003712104
1900004164104
1900004174104
1900004582104
1900004583104
1900004591104
1900004594104
1900004595104
1900004706104
1900004714104
1900004823104
1900004832104
1900004837104
1900005155104
1900005322104
1900007299104
1900007364104
1900007367104
1900007368104
1900007441104
1900007443104
1900007447104
