1900002086104
1900002094104
1900002390104
1900002396104
1900002424104
1900002427104
1900002503104
1900002685104
1900002739104
1900002792104
1900002796104
1900002868104
1900003633104
1900003635104
1900003711104
1900004165104
1900004377104
1900004592104
1900004593104
1900004596104
1900004713104
1900004821104
1900005156104
1900005321104
1900005324104
1900007288104
1900007289104
1900007290104
1900007294104
1900007363104
1900007373104
1900007376104
1900007442104
1900007446104
