1900001444104
1900001445104
1900001850104
1900001851104
1900001852104
1900001853104
1900002080104
1900002081104
1900002082104
1900002083104
1900002084104
1900002085104
1900002086104
1900002087104
1900002088104
1900002094104
1900002169104
1900002172104
1900002173104
1900002174104
1900002175104
1900002176104
1900002177104
1900002178104
1900002179104
1900002192104
1900002200104
1900002388104
1900002389104
1900002390104
1900002391104
1900002392104
1900002393104
1900002394104
1900002395104
1900002396104
1900002397104
1900002398104
1900002399104
1900002420104
1900002421104
1900002422104
1900002423104
1900002424104
1900002425104
1900002426104
1900002427104
1900002428104
1900002429104
1900002430104
1900002489104
1900002500104
1900002501104
1900002502104
1900002503104
1900002504104
1900002505104
1900002506104
1900002507104
1900002508104
1900002509104
1900002510104
1900002511104
1900002512104
1900002513104
1900002514104
1900002515104
1900002516104
1900002517104
1900002518104
1900002519104
1900002560104
1900002561104
1900002562104
1900002563104
1900002564104
1900002565104
1900002566104
1900002567104
1900002568104
1900002569104
1900002570104
1900002571104
1900002572104
1900002573104
1900002574104
1900002575104
1900002576104
1900002577104
1900002578104
1900002579104
1900002585104
1900002620104
1900002621104
1900002622104
1900002623104
1900002624104
1900002625104
1900002626104
1900002627104
1900002628104
1900002629104
1900002630104
1900002631104
1900002632104
1900002633104
1900002634104
1900002635104
1900002636104
1900002637104
1900002638104
1900002639104
1900002680104
1900002681104
1900002682104
1900002683104
1900002684104
1900002685104
1900002686104
1900002739104
1900002780104
1900002781104
1900002782104
1900002783104
1900002784104
1900002785104
1900002786104
1900002787104
1900002788104
1900002789104
1900002790104
1900002791104
1900002792104
1900002793104
1900002794104
1900002795104
1900002796104
1900002797104
1900002798104
1900002799104
1900002860104
1900002861104
1900002862104
1900002863104
1900002864104
1900002865104
1900002866104
1900002867104
1900002868104
1900002869104
1900002870104
1900002871104
1900002872104
1900002873104
1900002874104
1900002875104
1900002876104
1900002877104
1900002878104
1900002879104
1900003020104
1900003021104
1900003100104
1900003101104
1900003239104
1900003500104
1900003609104
1900003627104
1900003628104
1900003629104
1900003630104
1900003631104
1900003632104
1900003633104
1900003634104
1900003635104
1900003636104
1900003637104
1900003638104
1900003639104
1900003710104
1900003711104
1900003712104
1900003713104
1900003714104
1900003715104
1900003716104
1900003717104
1900003800104
1900003801104
1900003802104
1900004020104
1900004164104
1900004165104
1900004166104
1900004167104
1900004168104
1900004169104
1900004170104
1900004171104
1900004172104
1900004173104
1900004174104
1900004267104
1900004273104
1900004375104
1900004376104
1900004377104
1900004378104
1900004379104
1900004460104
1900004461104
1900004462104
1900004463104
1900004464104
1900004465104
1900004466104
1900004467104
1900004468104
1900004469104
1900004470104
1900004471104
1900004472104
1900004473104
1900004474104
1900004475104
1900004476104
1900004477104
1900004478104
1900004479104
1900004580104
1900004581104
1900004582104
1900004583104
1900004584104
1900004585104
1900004591104
1900004592104
1900004593104
1900004594104
1900004595104
1900004596104
1900004597104
1900004598104
1900004599104
1900004700104
1900004701104
1900004702104
1900004703104
1900004704104
1900004705104
1900004706104
1900004707104
1900004708104
1900004709104
1900004710104
1900004711104
1900004712104
1900004713104
1900004714104
1900004715104
1900004716104
1900004717104
1900004718104
1900004719104
1900004820104
1900004821104
1900004822104
1900004823104
1900004824104
1900004825104
1900004826104
1900004827104
1900004828104
1900004829104
1900004830104
1900004831104
1900004832104
1900004833104
1900004834104
1900004835104
1900004836104
1900004837104
1900004838104
1900004839104
1900005152104
1900005153104
1900005154104
1900005155104
1900005156104
1900005320104
1900005321104
1900005322104
1900005323104
1900005324104
1900005325104
1900005326104
1900005633104
1900007288104
1900007289104
1900007290104
1900007291104
1900007292104
1900007293104
1900007294104
1900007295104
1900007296104
1900007297104
1900007298104
1900007299104
1900007360104
1900007361104
1900007362104
1900007363104
1900007364104
1900007365104
1900007366104
1900007367104
1900007368104
1900007369104
1900007370104
1900007371104
1900007372104
1900007373104
1900007374104
1900007375104
1900007376104
1900007377104
1900007378104
1900007379104
1900007440104
1900007441104
1900007442104
1900007443104
1900007444104
1900007445104
1900007446104
1900007447104
1900007448104
