1900002084104
1900002085104
1900002088104
1900002509104
1900007295104
1900007296104
1900007444104
1900007445104
1900007448104
