1900002084104
1900002085104
1900002086104
1900002088104
1900002094104
1900002169104
1900002172104
1900002173104
1900002174104
1900002389104
1900002390104
1900002395104
1900002396104
1900002399104
1900002424104
1900002425104
1900002427104
1900002428104
1900002430104
1900002503104
1900002506104
1900002509104
1900002685104
1900002739104
1900002789104
1900002792104
1900002795104
1900002796104
1900002799104
1900002868104
1900002877104
1900003633104
1900003635104
1900003638104
1900003710104
1900003711104
1900003712104
1900004164104
1900004165104
1900004174104
1900004377104
1900004582104
1900004582106
1900004583104
1900004583106
1900004591104
1900004592104
1900004593104
1900004594104
1900004595104
1900004596104
1900004706104
1900004713104
1900004714104
1900004821104
1900004823104
1900004832104
1900004837104
1900005155104
1900005156104
1900005321104
1900005322104
1900005324104
1900005326104
1900007288104
1900007289104
1900007290104
1900007294104
1900007295104
1900007296104
1900007299104
1900007363104
1900007364104
1900007367104
1900007368104
1900007373104
1900007376104
1900007441104
1900007442104
1900007443104
1900007443106
1900007444104
1900007445104
1900007446104
1900007447104
1900007448104
