1000005797001
1000005798001
1000005799001
1000005800001
1000005801001
1000005802001
1000005804001
1000005805001
1000005806001
1000005807001
1000005839001
1000005880001
1000005881001
1000005882001
1000005883001
1000005884001
1000005935001
1000005936001
1000005937001
1000005939001
1000005981001
1000005991001
1000005992001
1000005994001
1000005995001
1000005996001
1000006052001
1000006053001
1000006096001
1000006097001
1000006100001
1000006149001
1000006150001
1000006151001
1000006156001
1000006157001
1000006158001
1000006205001
1000006206001
1000006207001
1000006208001
1000006256001
1000006258001
1000006259001
1000006304001
1000006305001
1000006306001
1000006307001
1000006351001
1000006352001
1000006353001
1000006382001
1000006404001
1000006405001
1000006406001
1000006407001
1000006408001
1000006434001
1000006454001
1000006455001
1000006456001
1000006458001
1000006499001
1000006500001
1000006501001
1000006502001
1000006503001
1000006504001
1000006506001
1000006507001
1000006508001
1000006509001
1000006510001
1000006569001
1000006570001
1000006574001
1000006575001
1000006618001
1000006655001
1000006658001
1000006659001
1000006660001
1000006703001
1000006704001
1000006705001
1000006739001
1000006740001
1000006771001
1000006772001
1000006785001
1000006786001
1000006787001
1000006789001
1000006820001
1000006821001
1000006835001
1000006836001
1000006837001
1000006838001
1000006839001
1000006840001
1000006866001
1000006893001
1000006894001
1000006895001
1000006896001
1000006897001
1000006943001
1000006944001
1000006945001
1000006949001
1000006950001
1000006981001
1000007005001
1000007006001
1000007007001
1000007011001
1000007012001
1000007013001
1000007052001
1000007070001
1000007072001
1000007073001
1000007118001
1000007119001
1000007120001
1000007122001
1000007123001
1000007130001
1000007178001
1000007218001
1000007220001
1000007221001
1000007262001
1000007263001
1000007264001
1000007265001
1000007311001
1000007312001
1000007313001
1000007314001
1000007344001
1000007364001
1000007367001
1000008250003
1000008251003
1000008252003
1000008367003
1000008368003
