1000009019016
1000009041016
1000009061016
1000009066016
1000009069016
1000009086016
1000009093016
1000009104016
1000009142016
1000009145016
1000009155016
1000009166016
1000009187016
1000009191016
1000009254016
1000009268016
1000009269016
1000009294016
1000009310016
1000009320016
1000009323016
1000009388016
1000009406016
1000009453016
1000009471016
1000009505016
1000009519016
1000009520016
1000009613016
1000009619016
1000009632016
1000009642016
1000009756016
1000009762016
1000009797016
1000009798016
1000009802016
1000009813016
1000009822016
1000009826016
1000009842016
1000009845016
1000009851016
1000009948016
1000009987016
1000010005016
1000010055016
1000010071016
1000010080016
1000010089016
1000010091016
1000010093016
1000010103016
1000010108016
1000010138016
1000010160016
1000010180016
1000010182016
1000010187016
1000010215016
1000010243016
1000010253016
1000010271016
1000010281016
1000010315016
1000010316016
1000010319016
1000010332016
1000010350016
1000010351016
1000010352016
1000010375016
1000010386016
1000010387016
1000010388016
1000010389016
1000010390016
1000010391016
1000010392016
1000010393016
1000010394016
1000010395016
1000010396016
1000010397016
1000010398016
1000010399016
1000010400016
1000010401016
1000010402016
1000010403016
1000010404016
1000010405016
1000010406016
1000010407016
1000010408016
1000010409016
1000010410016
1000010411016
1000010412016
1000010413016
1000010414016
1000010415016
1000010416016
1000010417016
1000010418016
1000010419016
1000010420016
1000010421016
1000010422016
1000010423016
1000010424016
1000010425016
1000010426016
1000010427016
1000010428016
1000010429016
1000010430016
1000010431016
1000010432016
1000010433016
1000010434016
1000010435016
1000010436016
1000010437016
1000010438016
1000010439016
1000010440016
1000010441016
1000010442016
1000010443016
1000010444016
1000010445016
1000010446016
1000010447016
1000010448016
1000010449016
1000010450016
1000010451016
1000010452016
1000010453016
1000010454016
1000010455016
1000010456016
1000010457016
1000010458016
1000010459016
1000010461016
1000010462016
1000010463016
1000010464016
1000010465016
1000010479016
1000010498016
1000010518016
1000010553016
1000010566016
1000010570016
1000010577016
1000010578016
1000010579016
1000010580016
1000010581016
1000010582016
1000010583016
1000010584016
1000010585016
1000010586016
1000010587016
1000010588016
1000010589016
1000010590016
1000010591016
1000010592016
1000010593016
1000010594016
1000010595016
1000010596016
1000010597016
1000010598016
1000010717016
1000010733016
1000010833016
1000010998016
1000010999016
1000011000016
1000011001016
1000011002016
1000011003016
1000011004016
1000011005016
1000011006016
1000011007016
1000011008016
1000011009016
1000011010016
1000011011016
1000011012016
1000011013016
1000011014016
1000011015016
1000011016016
1000011017016
1000011018016
1000011019016
1000011020016
1000011021016
1000011022016
1000011023016
1000011054016
1000011074016
1000011099016
1000011117016
1000011124016
1000011126016
1000011150016
1000011151016
1000011168016
1000011186016
1000011189016
1000011195016
1000011203016
1000011209016
1000011269016
1000011271016
1000011288016
1000011316016
1000011332016
1000011352016
1000011372016
1000011377016
1000011410016
1000011417016
1000011456016
1000011489016
1000011526016
1000011528016
1000011532016
1000011550016
1000011553016
1000011563016
1000011588016
1000011591016
1000011616016
1000011629016
1000011645016
1000011663016
1000011675016
1000011708016
1000011726016
1000011742016
1000011760016
1000011766016
1000011785016
1000011793016
1000011799016
1000011844016
1000011856016
1000011858016
1000011873016
1000011920016
1000011923016
1000011925016
1000011955016
1000011958016
1000011960016
1000011964016
1000011970016
1000011973016
1000011985016
1000012008016
1000012017016
1000012023016
1000012041016
1000012042016
1000012061016
1000012106016
1000012120016
1000012126016
1000012131016
1000012133016
1000012151016
1000012160016
1000012163016
1000012164016
1000012183016
1000012209016
1000012230016
1000012237016
1000012256016
1000012263016
1000012268016
1000012270016
1000012284016
1000012300016
1000012310016
1000012376016
1000012385016
1000012412016
1000012423016
1000012427016
1000012474016
1000012508016
1000012589016
1000012592016
1000012597016
1000012614016
1000012643016
1000012678016
1000012689016
1000012708016
1000012709016
1000012749016
1000012779016
1000012868016
1000012869016
1000012900016
1000012919016
1000012921016
1000012986016
1000013003016
1000013024016
1000013028016
1000013031016
1000013032016
1000013053016
1000013147016
1000013174016
1000013180016
1000013182016
1000013193016
1000013194016
1000013228016
1000013229016
1000013265016
1000013279016
1000013289016
1000013298016
1000013299016
1000013312016
1000013319016
1000013340016
1000013364016
1000013366016
1000013374016
1000013407016
1000013421016
1000013479016
